操作	オペレーション
operation	オペレーション
オペレーター	オペレータ
オーバーヘッド	オーバヘッド
アクセラレーター	アクセラレータ
パラメーター	パラメータ
パラメタ	パラメータ
インタープリター	インタープリタ
インタプリタ	インタープリタ
例え	たとえ
ストラテジー	ストラテジ
ライフタイム	存続期間
checkpoint	チェックポイント
。：	：
リストア	復元
全て	すべて
トレーニング	学習
本番	プロダクション
言え	いえ
言う	いう
言わ	いわ
様々	さまざま
良い	よい
持つ	もつ
通り	とおり
既に	すでに
一通り	ひととおり
他の	ほかの
分かる	わかる
綺麗	きれい
その時	そのとき
従って	したがって
お勧め	おすすめ
関わらず	かかわらず
予め	あらかじめ
何故	なぜ
故に	ゆえに
上手く	うまく
専ら	もっぱら
全く	まったく
先程	さきほど
初めて	はじめて
幾つか	いくつか
一旦	いったん
最も	もっとも
何れ	いずれ
丁度	ちょうど
殆ど	ほとんど
敢えて	あえて
幾つ	いくつか
後から	あとから
見つけ	みつけ
有る	ある
無い	ない
分かり辛い	わかりづらい
易い	やすい
移る	うつる
同じ	おなじ
続け	つづけ
選ぶ	えらぶ
選ん	えらん
仕組み	しくみ
沿う	そう
沿って	そって
沿った	そった
レイヤ	レイヤー
Tensorflow	TensorFlow
ディレクトリー	ディレクトリ
コミュニティー	コミュニティ
ユーザ	ユーザー
サーバ	サーバー
カラム	列
コラム	列
ウェイト	重み
ウエイト	重み
weight	重み
Weight	重み
eager実行	Eager Execution
eager execution	Eager Execution
Eager execution	Eager Execution
Eager実行	Eager Execution
eager 実行	Eager Execution
Eager 実行	Eager Execution
購買	勾配
常套句	イディオム
